11111111111111111111
1C000000000000000001
11111001111111111111
100C100000C0000100C1
100010000000C0010001
101110C0000000000001
1011111111111C111111
101C00000P000C001001
1000C0000C000000E0C1
11111111111111111111
