111111111
1C0100001
101100001
100000001
1000P0001
11100C001
1000C11E1
100001001
111111111