1111111111111111111111111111111111
1C000000C0100000001C1C01C000000101
111111101C1C1111011010011111011101
1P0000001000100000001000000100C101
1111101011111111011011110001011101
100000000C0010000C1010000000000101
1011101111111011101110011111111101
100010101C0C0010001C00011111111101
10111010101C1110111C11011111111101
101000001C10100000001C011111111101
10101111101010000110100CCCCCCCCC01
101C1000000C101000101001111C111101
11101011111C101110111001111C111101
1C0010100010101010000001111C111111
101010111011101011111101111C111101
1E10100010100000000C0C01111C111101
1111111111111111111111111111111111
