111111111
1C0CP01E1
10M0100C1
1C0C001M1
111111111