111111111
1C0CP01E1
1MM0100C1
1CMC001M1
111111111
